40x10
##########S#############################
#P      #       T        #             #
#  ###  #  ###########   #  #########  #
#  #T#  #           #    #  #     A #  #
#  # #  #######  ####    #  # #######  #
#    #        #  #       #  # #     #  #
#  ####  ######  #  #### #  # #  T  #  #
#      A         #          #    ####  #
#                #          #          #
########################################